XXXXXXXXXXXXXXXXXXXXXXXXXXXXXXXXX
X11111111111111111111111111G1111X
X1111111111111111111111111111111X
X1111111111111111111111111111111X
XXXXXXXXXXXXXXXXXXXXXXXXXXXXX1111X
X1111111111111111111111111111X11X
X1111111111111111111111111111X11X
X1111111111111111111111111111X11X
X1111111111111111111111111111X11X
X1111111111111111111111111111X11X
X1111111111111111111111111111X11X
X1111111111111111111111111111X11X
X11111S1XXXXXXXXXXXXXXXXXXXXXXX1X
X1111111111111111111111111111111X
X1111111111111111111111111111111X
XXXXXXXXXXXXXXXXXXXXXXXXXXXXXXXXX