XXXXXXXXXXXXXXXXXXXXXXXXXXXXXXXXX
XS111111111111111111111111111111X
X1111111111111111111111111111111X
X1111111111111111111111111111111X
X1111111111111111111111111111111X
X1111111111111111111111111111111X
X1111111111111111111111111111111X
X1111111111111111111111111111111X
X1111111111111111111111111111111X
X1111111111111111111111111111111X
X1111111111111111111111111111111X
X1111111111111111111111111111111X
X1111111111111111111111111111111X
X111111111111111111111111111111GX
X1111111111111111111111111111111X
XXXXXXXXXXXXXXXXXXXXXXXXXXXXXXXXX