XXXXXXXXXXXXXXXXXXXXXXXXXXXXXXXXX
XS99999999999999999999999999999GX
X1XX1111111111111111111111111XX1X
X1X111111111111111111111111111X1X
X1X111111111111111111111111111X1X
X1X111111111111111111111111111X1X
X1X111111111111111111111111111X1X
X1X111111111111111111111111111X1X
X1X111111111111111111111111111X1X
X1X111111111111111111111111111X1X
X1X111111111111111111111111111X1X
X1X111111111111111111111111111X1X
X1X111111111111111111111111111X1X
X1XXXXXXXXXXXXXXXXXXXXXXXXXXXXX1X
X1111111111111111111111111111111X
XXXXXXXXXXXXXXXXXXXXXXXXXXXXXXXXX