XXXXXXXXXXXXXXXXXXXXXXXXXXXXXXXXX
XS111111111111111XXXXXXXXXXXXXXXX
XXXXXXXXXXXXXXXX1XXXXXXXXXXXXXXXX
XXXXXXXXXXXXXXXX1XXXXXXXXXXXXXXXX
XXXXXXXXXXXXXXXX1XXXXXXXXXXXXXXXX
XXXXXXXXXXXXXXXX1XXXXXXXXXXXXXXXX
XXXXXXXXX11111111XXXXXXXXXXXXXXXX
XXXXXXXXX1XXXXXXXXXXXXXXXXXXXXXXX
XXXXXXXXX1XXXXXXXXXXXXXXXXXXXXXXX
XXXXXXXXX111111111111111XXXXXXXXX
XXXXXXXXXXXXXXXXXXXXXXX1XXXXXXXXX
XXXXXXXXXXXXXXXXXXXXXXX1111111GXX
XXXXXXXXXXXXXXXXXXXXXXXXXXXXXXXXX
XXXXXXXXXXXXXXXXXXXXXXXXXXXXXXXXX
XXXXXXXXXXXXXXXXXXXXXXXXXXXXXXXXX
XXXXXXXXXXXXXXXXXXXXXXXXXXXXXXXXX