XXXXXXXXXXXXXXXXXXXXXXXXXXXXXXXXX
X1111111111111111111111111111111X
XSXXXXXXXXXXXXXXX9XXXXXXXXXXXXXXX
X1111111111111111911111111111111X
X1XXXXXXXXXXXXXXX9XXXXXXXXXXXXX1X
X1X11111111111111911111111111X1X
X1X1XXXXXXXXXXXXX9XXXXXXXXX1X1X
X1X1X111111111111911111111X1X1X
X1X1X1XXXXXXXXXXX9XXXXXXX1X1X1X
X1X1X1X11111111119111111X1X1X1X
X1X1X1X1XXXXXXXXX9XXXXX1X1X1X1X
X1X1X1X1X1111111191111X1X1X1X1X
X1X1X1X1X1XXXXXXXXGXX1X1X1X1X1X
X1X1X1X1X1111111111111X1X1X1X1X
X111111111111111111111111111111X
XXXXXXXXXXXXXXXXXXXXXXXXXXXXXXXXX