XXXXXXXXXXXXXXXXXXXXXXXXXXXXXXXXX
X1111111111111111111111111111111X
X1111111111111111111111111111111X
X1111111111111111111111111111111X
X1111111111111111111111111111111X
X1111111111111111111111111111111X
X1111111111111111111111111111111X
X1S1111111111111111111111111111GX
X1111111111111111111111111111111X
X1111111111111111111111111111111X
X1111111111111111111111111111111X
X1111111111111111111111111111111X
X1111111111111111111111111111111X
X1111111111111111111111111111111X
X1111111111111111111111111111111X
XXXXXXXXXXXXXXXXXXXXXXXXXXXXXXXXX